oh dear=oh-dear
coronado yachts=coronado-yachts
giovanni antonio farina=giovanni-antonio-farina
central dawgs=central-dawgs
scarlet-capped fruit dove=scarlet-capped-fruit-dove
idagawa station=idagawa-station
deviated instinct=deviated-instinct
the winthrop woman=the-winthrop-woman
edwy searles brooks=edwy-searles-brooks
operation green quest=operation-green-quest
wim jonk=wim-jonk
petteri rasi=petteri-rasi
william truesdale=william-truesdale
ogwu james onoja=ogwu-james-onoja
david paton balfour=david-paton-balfour
rune almenning jarstein=rune-almenning-jarstein
americans in turkey=americans-in-turkey
melody perkins=melody-perkins
sanjin bezdrob=sanjin-bezdrob
fred hynes=fred-hynes
rg-31 nyala=rg-31-nyala
thrush-like antpitta=thrush-like-antpitta
everywhere but home=everywhere-but-home
favourite-longshot bias=favourite-longshot-bias
matthew barnaby=matthew-barnaby
olga rozanova=olga-rozanova
hierarchical epistemology=hierarchical-epistemology
trials evolution=trials-evolution
abercorn restaurant bombing=abercorn-restaurant-bombing
joseph mullin=joseph-mullin
phillip thuaux=phillip-thuaux
naylor-leyland baronets=naylor-leyland-baronets
cogswell tower=cogswell-tower
seven presidents park=seven-presidents-park
sea pottery=sea-pottery
eleutherodactylus lindae=eleutherodactylus-lindae
astra iva=astra-iva
kit rachlis=kit-rachlis
ptychobela opisthochetos=ptychobela-opisthochetos
order of manitoba=order-of-manitoba
niels bernhart=niels-bernhart
alfredo corvino=alfredo-corvino
toyo university=toyo-university
coleherne public house=coleherne-public-house
frank wilkinson=frank-wilkinson
acute muscle soreness=acute-muscle-soreness
aknysta river=aknysta-river
coringa wildlife sanctuary=coringa-wildlife-sanctuary
stabilization policy=stabilization-policy
giant antshrike=giant-antshrike
lindsay and crouse=lindsay-and-crouse
huck betts=huck-betts
white flint mall=white-flint-mall
fronimo dialogo=fronimo-dialogo
education in malta=education-in-malta
william beldue=william-beldue
fiji snake=fiji-snake
panamint alligator lizard=panamint-alligator-lizard
entoloma myrmecophilum=entoloma-myrmecophilum
caswell bay=caswell-bay
john folse=john-folse
adventure camp=adventure-camp
cree lake=cree-lake
captain quazar=captain-quazar
katherine victor=katherine-victor
hotel africana=hotel-africana
woodperry house=woodperry-house
alfred pupunu=alfred-pupunu
battle of tukaroi=battle-of-tukaroi
hassan turabi=hassan-turabi
esperance mallee=esperance-mallee
hamir of mewar=hamir-of-mewar
smock parachutist dpm=smock-parachutist-dpm
ymca camp cory=ymca-camp-cory
piz sena=piz-sena
walsall wood=walsall-wood
citrus stadium=citrus-stadium
minton ware=minton-ware
william golding=william-golding
babelomurex spinosus=babelomurex-spinosus
frederick richards leyland=frederick-richards-leyland
ngkoth language=ngkoth-language
osborn engineering company=osborn-engineering-company
wakefield power station=wakefield-power-station
instrument flight rules=instrument-flight-rules
davisville subway yard=davisville-subway-yard
jenny schmidgall-potter=jenny-schmidgall-potter
trofeo delle regioni=trofeo-delle-regioni
lynn johnson=lynn-johnson
mohamed mrabet=mohamed-mrabet
islamic terrorism=islamic-terrorism
pain ab=pain-ab
oracle enterprise manager=oracle-enterprise-manager
marcus fizer=marcus-fizer
jonathan aaron=jonathan-aaron
secondary neoplasm=secondary-neoplasm
richard zouch=richard-zouch
hilley gewog=hilley-gewog
traction power network=traction-power-network
francis william drake=francis-william-drake
castle mountain=castle-mountain
billy higgins=billy-higgins
jupiter project=jupiter-project
chautauqua carts=chautauqua-carts
pskov oblast=pskov-oblast
stuart young=stuart-young
oath more judaico=oath-more-judaico
charlotte sting=charlotte-sting
complement component 2=complement-component-2
wayne cole=wayne-cole
wright pulsar=wright-pulsar
galoa island=galoa-island
potato ricer=potato-ricer
pagaruyung kingdom=pagaruyung-kingdom
robin shea=robin-shea
connecting futures=connecting-futures
alasmidonta viridis=alasmidonta-viridis
genetic analysis=genetic-analysis
bill myerscough=bill-myerscough
the property ombudsman=the-property-ombudsman
ashur-dan i=ashur-dan-i
