afghan=afghanistan
afghani=afghanistan
paki=pakistan
pakistani=pakistan
nyc=new-york-city
gta3=grand-theft-auto
gta4=grand-theft-auto
koreans=korea
korean=korea
australian=australia
iranian=iran
kuwaiti=kuwait
egyptian=egypt
politicians=politician
pakistanis=pakistan
pageants=pageant
sings=sing
chinese=china
raids=raid
semiconductors=semiconductor
blocks=block
olympic=olympics
website=web-site
candidates=candidate
gives=give
candidates=candidate
trumps=trump
businesses=business
argentine=argentina
nkorea=north-korea
govt=government
armenian=armenia
brazilian=brazil
brazilians=brazil
armenians=armenia
japanese=japan
kony2012=kony
kony-2012=kony
ww2=world-war-2
ww1=world-war-1
peruvians=peru
peruvian=peru
american=usa
americans=usa
moms=mother
mom=mother
mothers=mother
fathers=father
dad=father
dads=father
sisters=sister
brothers=brother
planets=planet
suns=sun
earths=earth
gates=gate
names=name
named=name
tarrifs=tarrif
satellites=satellite
streets=street
avenues=avenue
says=say
allows=allow
sexist=sexism
racist=racism
miners=miner
words=word
sentences=sentence
links=link
services=service
extensions=extension
definitions=definition
tests=test
dogs=dog
cats=cat
religions=religion
changes=change
anagrams=anagram
groups=group
girlfriends=girlfriend
communities=community
couples=couple
friends=friend
nutrients=nutrient
developers=developer
democrats=democratic-party
democrat=democratic-party
republicans=republican-party
republican=republican-party
dems=democratpic-party
repubs=republican-party
abq=albuquerque
presidential=president
schedules=schedule
opinions=opinion
rates=rate
guys=guy
ladies=lady
gentlemen=gentleman
men=man
women=woman
physicists=physicist
computers=computer
decisions=decision
scissors=scissor
bugs=bug
hills=hill
murderers=murderer
german=germany
sane=sanity
insane=sanity
insanity=sanity
inflammable=flammable
segregated=segregation
segregate=segregation
potentials=potential
pythonic=python
russian=russia
liberian=liberia
liberians=liberia
environmental=environment
environmentalism=environment
environmentalism=environment
conservatives=conservative
liberals=liberal
progressives=progressive
libertarians=libertarian
readings=reading
billboards=billboard
blurays=bluray
dvds=dvd
years=year
rules=rule
problems=problem
knows=know
corrects=correct
foss=open-source
wrongs=wrong
flashbacks=flashback
drugs=drug
methamphetamine=meth
methamphetamines=meth
marijuana=cannabis
tv=television
phone=telephone
cellphone=mobile-phone