world of warcraft=world-of-warcraft
united states of america=usa
u.s.a.=usa
u.s.=usa
e.u.=european-union
u.n.=united-nations
c++=c-plus-plus
cpp=c-plus-plus
united nations=united nations
united states=usa
google chrome=google-chrome
3d printing=3d-printing
3-d printing=3d-printing
media player=media-player
social media=social-media
windows phone=windows-phone
hacker news=hacker-news
google voice=google-voice
google mail=gmail
breaking bad=breaking-bad
kate winslet=kate-winslet
celine dion=celine-dion
throw up=throw-up
walking dead=walking-dead
the office=the-office
u of i=uiuc
bin laden=bin-laden
university of illinois=uiuc
guido van rossum=guido-van-rossum
linus torvalds=linux-torvalds
julian assange=julian-assange
april fools=april-fools
barack obama=barack-obama
hillary clinton=hillary-clinton
bill clinton=bill-clinton
mitt romney=mitt-romney
rick santorum=rick-santorum
ron paul=ron-paul
artificial intelligence=artificial-intelligence
george bush=george-w-bush
george w. bush=george-w-bush
george h.w. bush=george-hw-bush
george bush sr.=george-hw-bush
george bush jr.=george-w-bush
new york city=new-york-city
new york state=new-york
new york=new-york
ars technica=ars-technica
washington dc=washington-dc
washington, dc=washington-dc
washington, d.c.=washington-dc
washington d.c.=washington-dc
tiger woods=tiger-woods
pga tour=pga-tour
macky sall=macky-sall
jennifer lawrence=jennifer-lawrence
miley cyrus=miley-cyrus
mad men=mad-men
office space=office-space
los angeles=los-angeles
las vegas=las-vegas
white sox=white-sox
red sox=red-sox
hong kong=hong-kong
north korea=north-korea
south korea=south-korea
pope benedict xvi=pope-benedict
ryan howard=ryan-howard
arnold palmer=arnold-palmer
pope benedict=pope-benedict
hugo chavez=hugo-chavez
goldman sachs=goldman-sachs
newt gingrich=newt-gingrich
ronald reagan=ronald-reagan
adolf hitler=adolf-hitler
michele bachmann=michele-bachmann
derrick smith=derrick-smith
windows 8=windows-8
hunger games=hunger-games
harry potter=harry-potter
kim kardashian=kim-kardashian
whitney houston=whitney-houston
michael jackson=michael-jackson
bobby jenks=bobby-jenks
james cameron=james-cameron
snow owl=snow-owl
angry birds=angry-birds
international space station=international-space-station
iss=international-space-station
dick cheney=dick-cheney
al gore=al-gore
american idol=american-idol
pink slime=pink-slime
hilary duff=hilary-duff
jessica simpson=jessica-simpson
kendall marshall=kendall-marshall
raspberry pi=raspberry-pi
sufjan stevens=sufjan-stevens
david cameron=david-cameron
mariana trench=mariana-trench
net neutrality=net-neutrality
climate change=climate-change
global warming=global-warming
downing street=downing-street
jeremy howard=jeremy-howard
guillermo rauch=guillermo-rauch
quantum mechanics=quantum-mechanics
trayvon martin=trayvon-martin
capitol hill=capitol-hill
grand theft auto=grand-theft-auto
world bank=world-bank
n. korea=north-korea
rupert murdoch=rupert-murdoch
palm sunday=palm-sunday
nuclear arms=nuclear-arms
aung san suu kyi=aung-san-suu-kyi
nuclear weapons=nuclear-arms
south american=south-america
south america=south-america
south africa=south-africa
s. africa=south-africa
s africa=south-africa
great britain=great-britain
united kingdom=united-kingdom
deepwater horizon=deepwater-horizon
power plant=power-plant
s. america=south-america
s america=south-america
north american=north-america
north america=north-america
n. america=north-america
n america=north-america
muslim brotherhood=muslim-brotherhood
stack overflow=stack-overflow
bus driver=bus-driver
web site=web-site
bill gates=bill-gates
william gates=bill-gates
sin city=sin-city
donald trump=donald-trump
constitutional assembly=constitutional-assembly
assembly programming=assembly-programming
gov.=governor
.gov=dot-gov
.com=dot-com
.net=dot-net
.org=dot-org
chrome os=chrome-os
george zimmerman=george-zimmerman
bay area=bay-area
terms of service=terms-of-service
commodore 64=commodore-64
mount kailash=mount-kailash
invisible children=invisible-children
pirate bay=pirate-bay
bo xilai=bo-xilai
soviet union=soviet-union
world war 2=world-war-2
world war 1=world-war-1
world war iii=world-war
world war ii=world-war-2
world war i=world-war-1
world war=world-war
game of thrones=game-of-thrones
pirate party=pirate-party
pirate parties=pirate-party
joss whedon=joss-whedon
rick santorum=rick-santorum
neil patrick harris=neil-patrick-harris
business card=business-card
year old=year-old
years old=year-old
years-old=year-old
republican party=republican-party
democratic party=democratic-party
democrat party=democratic-party
north dakota=north-dakota
south dakota=south-dakota
saint louis=saint-louis
st. louis=saint-louis
new mexico=new-mexico
rio grande=rio-grande
bernalillo county=bernalillo-county
new england=new-england
new hampshire=new-hampshire
new jersey=new-jersey
car alarm=car-alarm
portuguese=portugal
alarm clock=alarm-clock
sky net=skynet
monty python=monty-python
pythonesque=monty-python
pink floyd=pink-floyd
led zeppelin=led-zeppelin
the who=the-who
black sabbath=black-sabbath
ron paul=ron-paul
ipod shuffle=ipod-shuffle
ipod nano=ipod-nano
ipod touch=ipod-touch
ipod itouch=ipod-touch
itouch=ipod-touch
samsung galaxy=samsung-galaxy
breaking bad=breaking-bad
blu ray=bluray
blu rays=bluray
crystal meth=meth
bob odenkirk=bob-odenkirk
mexico city=mexico-city
harry potter=harry-potter
darth vader=darth-vader
ron weasley=ron-weasley
ronald weasley=ron-weasley
hermione granger=hermione-granger
lord voldemort=voldemort
albus dumbledore=dumbledore
severus snape=severus-snape
professor snape=severus-snape
draco malfoy=draco-malfoy
kanye west=kanye-west
nicki minaj=nicki-minaj
mobile phone=mobile-phone
cell phone=mobile-phone
open sources=open-source
open source=open-source
gplv2=gpl
gplv3=gpl
functional programming=functional-programming
multi-core=mutlicore
dual core=multicore
native americans=native-american
native american=native-american
american indian=native-american
dark matter=dark-matter
richard feynman=richard-feynman
university of california=university-of-california
uc berkeley=university-of-california
uc-berkeley=university-of-california
nitric acid=nitric-acid
html 5=html5
app store=app-store
arab spring=arab-spring
new year's eve=new-year
new year's=new-year
new year=new-year
fiscal cliff=fiscal-cliff